+-------------------------------------------+
|                                           |
|     XXXXXXXXXXXXX                         |
|    XXXXXXXXXXXXXXX                        |
|   XXXX         XXXX                       |
|                XXXXX                      |
|                XXXXX                      |
|                XXXX                       |
|              XXXX                         |
|             XXXXX                         |
|            XXXX             XXXXXG        |
|           SXXX          XXXXXXXXXXXXXX    |
|            XXXX        XXXX       XXXXX   |
|            XXXXXX   XXXXXX        XXXXX   |
|              XXXXXXXX           XXXXX     |
|                 XXXXX           XXXX      |
|                                XXXX       |
|                              XXXX         |
|                                           |
+-------------------------------------------+